###                 #########
#   ###################   # #
# ####                # # # #
# ################### # # # #
#                     # # # #
##################### # # # #
#   ##                # # # #
# # ## ### ## ######### # # #
#A#    #   ## #         # # #
# # ## ################ # # #
# # ##             #### # # #
# # ############## ## # # # #
#               ##    # #B# #
###### ######## ####### # # #
###### ####             #   #
#      ######################
